::::::::::*******
:  * *        * *
:   *   *:*** * *
:*       :      *
:   * *  :::     
: **   **:      :
:*       :    ***
:** ***  :      *
:   *    ::     :
: ::::::::***:::*
*    **   *    **
::   :    :::   :
::   :    :     :
*** ********:::::
*           *****
*    ***        :
************::::*